#######################################
# Syntax Coloring Map For the current project.
# This file was generated by doxygen2keywords.xsl.
#######################################
#######################################
# Classes and structs (KEYWORD1)
#######################################
WeatherSensor::AirCO2	KEYWORD1
WeatherSensor::AirPM	KEYWORD1
WeatherSensor::AirVOC	KEYWORD1
WeatherSensor::Leakage	KEYWORD1
Lightning	KEYWORD1
WeatherSensor::Lightning	KEYWORD1
nvData_t	KEYWORD1
nvLightning_t	KEYWORD1
RainGauge	KEYWORD1
WeatherSensor::Sensor	KEYWORD1
SensorMap	KEYWORD1
WeatherSensor::Soil	KEYWORD1
WeatherSensor::Weather	KEYWORD1
WeatherSensor	KEYWORD1
#######################################
# Methods (KEYWORD2)
#######################################
Lightning	KEYWORD2
reset	KEYWORD2
hist_init	KEYWORD2
prefs_load	KEYWORD2
prefs_save	KEYWORD2
update	KEYWORD2
pastHour	KEYWORD2
lastCycle	KEYWORD2
lastEvent	KEYWORD2
RainGauge	KEYWORD2
set_max	KEYWORD2
reset	KEYWORD2
hist_init	KEYWORD2
update	KEYWORD2
pastHour	KEYWORD2
currentDay	KEYWORD2
currentWeek	KEYWORD2
currentMonth	KEYWORD2
Sensor	KEYWORD2
begin	KEYWORD2
radioReset	KEYWORD2
sleep	KEYWORD2
getData	KEYWORD2
getMessage	KEYWORD2
decodeMessage	KEYWORD2
genMessage	KEYWORD2
clearSlots	KEYWORD2
findId	KEYWORD2
findType	KEYWORD2
setSensorsInc	KEYWORD2
setSensorsExc	KEYWORD2
getSensorsInc	KEYWORD2
getSensorsExc	KEYWORD2
initList	KEYWORD2
findSlot	KEYWORD2
lfsr_digest16	KEYWORD2
add_bytes	KEYWORD2
crc16	KEYWORD2
log_message	KEYWORD2
setFlag	KEYWORD2
windspeed_ms_to_bft	KEYWORD2
calcdewpoint	KEYWORD2
calcwindchill	KEYWORD2
calcheatindex	KEYWORD2
calchumidex	KEYWORD2
perceived_temperature	KEYWORD2
calcdewpoint	KEYWORD2
calcwindchill	KEYWORD2
calcheatindex	KEYWORD2
calchumidex	KEYWORD2
perceived_temperature	KEYWORD2
winddir_flt_to_str	KEYWORD2
windspeed_ms_to_bft	KEYWORD2
#######################################
# Constants (LITERAL1)
#######################################
LIGHTNINGCOUNT_MAX_VALUE	LITERAL1
LIGHTNING_UPD_RATE	LITERAL1
LIGHTNING_HIST_SIZE	LITERAL1
DEFAULT_QUALITY_THRESHOLD	LITERAL1
RAINGAUGE_MAX_VALUE	LITERAL1
RAINGAUGE_UPD_RATE	LITERAL1
RAIN_HIST_SIZE	LITERAL1
DEFAULT_QUALITY_THRESHOLD	LITERAL1
RESET_RAIN_H	LITERAL1
RESET_RAIN_D	LITERAL1
RESET_RAIN_W	LITERAL1
RESET_RAIN_M	LITERAL1
SENSOR_TYPE_WEATHER0	LITERAL1
SENSOR_TYPE_WEATHER1	LITERAL1
SENSOR_TYPE_THERMO_HYGRO	LITERAL1
SENSOR_TYPE_POOL_THERMO	LITERAL1
SENSOR_TYPE_SOIL	LITERAL1
SENSOR_TYPE_LEAKAGE	LITERAL1
SENSOR_TYPE_AIR_PM	LITERAL1
SENSOR_TYPE_RAIN	LITERAL1
SENSOR_TYPE_LIGHTNING	LITERAL1
SENSOR_TYPE_CO2	LITERAL1
SENSOR_TYPE_HCHO_VOC	LITERAL1
WEATHER0_RAIN_OV	LITERAL1
WEATHER1_RAIN_OV	LITERAL1
DATA_COMPLETE	LITERAL1
DATA_TYPE	LITERAL1
DATA_ALL_SLOTS	LITERAL1
MSG_BUF_SIZE	LITERAL1
DECODE_INVALID	LITERAL1
DECODE_OK	LITERAL1
DECODE_PAR_ERR	LITERAL1
DECODE_CHK_ERR	LITERAL1
DECODE_DIG_ERR	LITERAL1
DECODE_SKIP	LITERAL1
DECODE_FULL	LITERAL1
NUM_SENSORS	LITERAL1
SENSOR_IDS_EXC	LITERAL1
SENSOR_IDS_INC	LITERAL1
WIND_DATA_FLOATINGPOINT	LITERAL1
WIND_DATA_FIXEDPOINT	LITERAL1
BRESSER_5_IN_1	LITERAL1
BRESSER_6_IN_1	LITERAL1
BRESSER_7_IN_1	LITERAL1
BRESSER_LIGHTNING	LITERAL1
BRESSER_LEAKAGE	LITERAL1
RAINGAUGE_USE_PREFS	LITERAL1
LIGHTNING_USE_PREFS	LITERAL1
USE_SX1276	LITERAL1
RECEIVER_CHIP	LITERAL1
STR_HELPER	LITERAL1
STR	LITERAL1
